          R 800 800                   
NO ./path_to_the_north_texture                   
                     SO                      ./path_to_the_south_texture
WE ./path_to_the_west_texture
EA                      ./path_to_the_east_texture                     
        S                                  ./path_to_the_sprite_texture                               
                 F 10,60,80                                  
          C 225,30,0

1111111111111111111111111       
1000000000110000000000001       
101100000111000000N000001       
1001000000000000000000001       
111111111000000000000000000001
10000000000001110111111111111
11110000111111011100000010001   
11110000111111011101010010001   
11000000110101011100000010001   
10000000000000001100000010001   
10000000000000001101010010001   
1100000111010101111101111000111 
11110111 1110101 101111010001   
11111111 1111111 111111111111   
