R 900 900                   
NO ./textures/bluestone.xpm
SO ./textures/eagle.xpm
WE ./textures/redbrick.xpm
EA ./textures/xpm_greystone.xpm
S  ./textures/barrel.xpm                            

F 185,122,87
C 153,217,234                                  

1111111111111
1000000000001
1000000000001
1000000000001
100000000001
1000000000001
111100000001
1  1000000001
111100000001
1000000000001
1000000000001
1010000011111
1000000000001
1010000000001
1000000000001
1000000000001
1000000000001
1020000000001
1000000000001
1000000000001
1000000000001
1000000000001
100000N000001
1000000000001
100000000001
1111111111111
