R 900 900                   
NO ./textures/eagle.xpm
SO ./textures/eagle.xpm
WE ./textures/redbrick.xpm
EA ./textures/bluestone.xpm
S  ./textures/barrel.xpm                            

F 185,122,87
C 153,217,234                                  

111111111111111111111111111111111111111111111111
100000000000000000000000000000000000000000000001
102000000000000000000000000000000000000000000001
100000000200000000000000000000000000000000000001
100000000000000000000000000000000000000000000001
100000000000000000000000000000000000000000000001
100000000000000000000000000000000000000000000001
1000000000000000000N0000000000000000000000000001
100000000000000000000000000000000000000000000001
100000000000000000000000000000000000000000000001
100000000000000000000000000000000000000000000001
100000000000000000000000000000000000000000000001
111111111111111111111111111111111111111111110001
100000001001001001001001001000100100100100010001
120000000000000000000000000000000000000000210001
100000001001001001001001001000100100100100010001
100000000000000000000000000000000000000000010001
100000001001001001001001001000100100100100010001
100000000000000000000000000000000000000000010001
100000001001001001001001001000100100100100010001
100000000000000000000000000000000000000000000001
100000001001001001001001001000100100100100010001
120000000000000000000000000000000000000000000001
111100000000111111111111111111111111111111111111
1  1000000001
1111000000001
1000000000001
1000000000001
1000000000001
1000000000001
1010000000001
1010000000001
1000000000001
1000000000001
1010000000001
1000000000001
1200000000001
1000000000001
1222200022221
1200000000001
1000000000001
1000000000001
1111111111111
