         R 800 800                   
NO ./path_to_the_north_texture                   
                     SO                      ./path_to_the_south_texture
WE ./path_to_the_west_texture
EA                      ./path_to_the_east_texture                     
        S                                  ./path_to_the_sprite_texture                               
                 F 10,0,50                                  
          C 0,0,150

1111111111111
1000000000001
1000000000001
1000000000001
100000000001
1000000000001
111100000001
1001000000001
111100000001
1000000000001
1000000000001
1010000011111
1000000000001
1010000000001
1000000000001
1000000000001
1000000000001
1000000000001
1000000000001
1000000000001
1000000000001
1000000000001
1000000N00001
1000000000001
1000000000001
1111111111111
