R 800 800                   
NO ./textures/xpm_greystone.xpm
SO ../textures/colorstone.png
WE ../textures/greenlight.png
EA ../textures/greystone.png
S  ../textures/redbrick.png                               

F 185,122,87
C 153,217,234   


111111111111111111111111111111111111111111111
100100100101000010000000100000000000100000001
100000001001110000001000000011000000010000001
100010000001110000010000000010000000100000001
100000000001110000001000000000100000000100001
10000000000000N000000000000000000000000000001
111111111111111111111111111111111111111111111
