R 800 800                   
NO ./textures/eagle.xpm
SO ./textures/eagle.xpm
WE ./textures/redbrick.xpm
EA ./textures/bluestone.xpm
S  ./textures/barrel.xpm                            

F 185,122,87
C 153,217,234                                  

111111111111111111111111111111111111111111111111
100000000000000000000000000000000000000000000001
100000000000000000000000000000000000000000000001
100000000000000000000000000000000000000000000001
1o0000000000000000000000000000000000000000000001
100000000000000000000000000000000000000000000001
100000000000000000000000000000000000000000000001
100000000000000000000000000000000000000000000001
100000111111111111111111111111111111111111111111
100000000000000010000000000000100000000001000001
100000001000000010000001000000100000000000000001
100000001000000000000001000000000000000001000001
111111111111111111111111111111111111111111100001
100000000000000000000000000000000000000000000001
100000000000000000000000000000000000000000000001
100000000000000000000000000000000000000000000001
100000000000000000000000000000000000000000000001
111111111111111111111111111111111111111111110001
100000001001001001001001001000100100100100010001
120000000000000000000000000000000000000000210001
100000001001001001001001001000100100100100010001
100000000000000000000000000000000000000000010001
100000001001001001001001001000100100100100010001
100000000000000000000000000000000000000000010001
100000001001001001001001001000100100100100010001
100000000000000000000000000000000000000000000001
100000001001001001001001001000100100100100010001
120000000000000000000000000000000000000000000001
111100000000111111111111111111111111111111111111
1001000000001
1111000000001
1000000000001
1000000000001
1000000000001
1000000000001
1010000000001
1010000000001
1000000000001
1000000000001
1010000000001
100000000000111111111111
120000000000000010000021
100000000000100000000001
10000000000010000W0000001
120000000000000010000021
100000000000111111111111
1000000000001
1111111111111
