         R 800 800                   
NO ./path_to_the_north_texture                   
                     SO                      ./path_to_the_south_texture
WE ./path_to_the_west_texture
EA                      ./path_to_the_east_texture                     
        S                                  ./path_to_the_sprite_texture                               
                 F 101,67,33                                  
          C 0,100,150

1111111111111
1000000000001
1000000000001
1000000000001
1000000000001
100000000000111
100000000000001
10000N000000111
1000000000001
1000000000001
1000000000001
1000000000001
1000000000001
1000000000001
1000000000001
1111111111111
